ste	ste
sam	sam
stiže	stiž
catering	catering
hrana	hran
sve	sve
došlo	došl
dostava	dostav
pizza	pizz
porcija	porcij
pizzeria	pizzeri
kulen	kulen
kobasica	kobasic
dostavljač	dostavljač
palačinka	palačink
klopa	klop
cijena	cijen
pollo	poll
piletina	piletin
tijesto	tijest
salata	salat
okus	okus
lepinja	lepinj
umak	umak
gyros	gyros
sir	sir
ćevap	ćevap
povrće	povrć
restoran	restoran
pomfrit	pomfri
roštilj	roštilj
meksički	meksičk
taquitos	taquitos
raffaelo	raffael
twix	twix
tvix	tvix
višnja	višnj
chili	chi
brancin	brancin
blitva	blitv
šampinjoni	šampinjon
pljeskavica	pljeskavic
zagrebački	zagrebačk
lignja	lignj
sastojak	sastojak
sendvič	sendvič
ćevap	ćevap
plata	plat
ponuda	ponud
količina	količin
gljiva	gljiv
kvaliteta	kvalitet
grah	gra
ražnjić	ražnjić
riža	riž
tortilje	tortilj
kruh	kruh
luk	luk
njok	njok
kebab	kebab
osoblje	osoblj
krumpir	krumpir
restani	restan
steak	steak
lazanje	lazanj
tartar	tartar
kroketi	kroket
junetina	junetin
količinski	količinsk
pakiranje	pakiranj
juha	juh
tjestenina	tjestenin
rebarca	rebarc
čokolada	čokolad
file	fi
peanuts	peanuts
bolognese	bolognes
pica	pic
tortille	tortill
tuna	tun
veličina	veličin
kroketima	kroket
meso	mes
krafna	krafn
riža	riž
sendvič	sendvič
jelo	jel
jela	jel
sastojak	sastojak
odrezak	odrezak
kuhinja	kuhinj
desert	desert
ponuda	ponud
rajčica	rajčic
jelovnik	jelovnik
začin	začin
tjestenina	tjestenin
gljiva	gljiv
pomes	pomes
usluga	uslug
špek	špek
ekipa	ekip
dojam	doja
oslić	oslić
omlet	omlet
pogačica	pogačic
pomfri	pomfr
ajvar	ajvar
paprika	paprik
ražnjići	ražnjić
kruh	kruh
kruhići	kruhić
kruščići	kruščić
slanina	slan
