loš	loš
čekati	čeka
plivati	pliva
komadić	komadić
kasniti	kasni
kriv	kriv
sirov	sirov
neukusan	neukusn
hladan	hladan
ništa	ništ
suh	suh
čekanje	čekanj
bezobrazan	bezobrazan
lažan	lažan
neprofesionalan	neprofesionaln
nula	nul
neljubazan	neljubazan
neznati	nezna
zagoren	zagoren
izgubiti	izgubi
nažalost	nažalost
visiti	visi
visjeti	visjet
žilav	žilav
kiseo	kise
ulje	ulj
baciti	baci
isprika	isprik
čudan	čudan
razliti	razli
slab	slab
pokvaren	pokvaren
jestiv	jestiv
mokar	mokar
užasan	užasan
mina	min
gladan	gladan
nedovoljan	nedovoljn
zagorene	zagoren
previše	previš
razočarati	razočara
neslan	neslan
nejestiv	nejestiv
razočaran	razočaran
čekam	čeka
nikakav	nikakav
strasan	strasan
užasno	užasn
grozan	grozn
razočaranje	razočaranj
najgore	najgor
bezukusan	bezukusn
kasan	kasan
razvodnjen	razvodnjen
katastrofa	katastrof
očajan	očajn
jadan	jadan
najgori	najgor
odvratan	odvratn
užas	užas
koma	kom
bačen	bačen
prosječan	prosječan
osrednji	osrednj
neugodan	neugodan
nejestiva	nejestiv
žalost	žalost
mlak	mlak
boli	bol
boliti	boli
boljeti	boljet
dlaka	dlak
tvrd	tvrd
premao	prema
bljutav	bljutav
prepečena	prepečen
smeće	smeć
bezukusno	bezukusn
preslano	preslan
bezukusna	bezukusn
sramota	sramot
preloše	preloš
kriviti	krivit
srednji	srednj
bezveze	bezvez
dočekati	dočeka
maknuti	makn
star	star
dno	dno
zamjerka	zamjerk
prigovor	prigovor
primjedba	primjedb
rijedak	rijedak
kajati	kaja
faliti	fali
greška	grešk
kasnije	kasn
poslije	poslij
problem	problem
propust	propust
duže_od_predviđenog	duže_od_predviđen
pogriješiti	pogriješi
pogreška	pogrešk
masna	masn
ne_dolaziti	ne_dolazit
ne_doći	ne_doć
nisu_doći	nisu_doć
nisu_dolaziti	nisu_dolazit
nije_doći	nije_doć
nije_dolaziti	nije_dolazit
nisu_imati	nisu_ima
nije_imati	nije_ima
ne_imati	ne_ima
ne_nazvati	ne_nazva
ne_pojaviti	ne_pojavi
nije_nazvati	nije_nazva
nije_pojaviti	nije_pojavi
nisu_nazvati	nisu_nazva
nisu_pojaviti	nisu_pojavi
smetati	smeta
ne_valjati	ne_valja
nije_valjati	nije_valja
nisu_valjati	nisu_valja
