ranije	ran
odličan	odličan
iskupljuje	iskupljuj
svjež	svjež
izvrstan	izvrstan
bravo	brav
super	super
obilan	obiln
najbolji	najbolj
fantastičan	fantastičn
hrskav	hrskav
fin	fin
oduševljen	oduševljen
dobar	dobar
predobar	predobar
ponovo	ponov
brz	brz
dovoljan	dovoljn
točan	točan
ugodan	ugodan
mekan	mekan
simpa	simp
plus	plus
rani	ran
raniti	rani
zadovoljan	zadovoljn
mrak	mrak
pohvala	pohva
ukusan	ukusn
velik	velik
kvaliteta	kvalitet
vrhunski	vrhunsk
ogroman	ogroman
pun	pun
preporučati	preporuča
zakon	zakon
pohvaliti	pohvali
dobriti	dobri
topao	topa
čast	čast
cijeniti	cijeni
preporučivati	preporučiva
ljubazan	ljubazan
preporuka	preporuk
brava	brav
povoljan	povoljn
odlične	odličn
vruć	vruć
vrući	vruć
brzina	brzin
prefina	prefin
savršena	savršen
bogat	bogat
pravi	prav
čist	čist
simpatičan	simpatičn
prihvatljiv	prihvatljiv
sviđati	sviđa
fenomenalan	fenomenaln
lijep	lijep
odlično	odličn
besplatan	besplatn
izniman	izniman
kvalitetan	kvalitetn
voljeti	voljet
gratis	gratis
cast	cast
pristojan	pristojan
šestica	šestic
solidan	solidan
good	good
taman	taman
isplatiti	isplatit
hvala	hva
njam	nja
vruća	vruć
oduševiti	oduševit
apsolutan	apsolutan
polizati	poliza
mljac	mljca
ponovan	ponovan
sočan	sočan
bogatiti	bogatit
petica	petic
liga	lig
prefine	prefin
svidjeti	svidjet
sviditi	svidi
svidilo	svidi
izdašan	izdašn
izvanredan	izvanredan
na_vrijeme	na_vrijem
prije_vremena	prije_vremen
prije_očekivanog	prije_očekivan
prije_navedenog_vremena	prije_navedenog_vremen
brza	brz
bolja	bolj
pet	pet
ok	ok
