ste	biti
sam	biti
stiže	stizati
catering	caterinj
hrana	hrana
sve	sve
došlo	doći
dostava	dostati
pizza	pizza
porcija	porcij
pizzeria	pizzeria
kulen	kulen
kobasica	kobasica
dostavljač	dostavljač
palačinka	palačinak
klopa	klop
cijena	cijena
pollo	poll
piletina	piletini
tijesto	tijesti
salata	salat
okus	okus
lepinja	lepinj
umak	umak
gyros	gyros
sir	sir
ćevap	ćevap
povrće	povrlik
restoran	restoran
pomfrit	pomfriti
roštilj	roštilk
meksički	meksička
taquitos	taquitos
raffaelo	raffael
twix	twix
tvix	tvix
višnja	višnj
chili	chil
brancin	brancin
blitva	blitv
šampinjoni	šampinjoan
pljeskavica	pljeskavica
zagrebački	zagrebačka
lignja	lignj
sastojak	sastojak
sendvič	sendvič
ćevap	ćevap
plata	plat
ponuda	ponuda
količina	količina
gljiva	gljiv
kvaliteta	kvaliteti
grah	gra
ražnjić	ražnjić
riža	rizak
tortilje	tortig
kruh	kruh
luk	luk
njok	njok
kebab	kebab
osoblje	osoblje
krumpir	krumpir
restani	restanin
steak	steak
lazanje	lazal
tartar	tartar
kroketi	kroketa
junetina	junetini
količinski	količinska
pakiranje	pakiral
juha	juh
tjestenina	tjestenini
rebarca	rebarac
čokolada	čokolado
file	fio
peanuts	peanuts
bolognese	bolognijeti
pica	pic
tortille	tortilo
tuna	tun
veličina	veličini
kroketima	krokete
meso	mesi
krafna	krafan
riža	rizak
sendvič	sendvič
jelo	jel
jela	o
sastojak	sastojak
odrezak	odrezak
kuhinja	kuhinj
desert	deserti
ponuda	ponuda
rajčica	rajčica
jelovnik	jelovnik
začin	začin
tjestenina	tjestenini
gljiva	gljiv
pomes	pomes
usluga	usluga
špek	špek
ekipa	ekip
dojam	dojam
oslić	oslić
omlet	omleti
pogačica	pogačica
pomfri	pomfar
ajvar	ajvar
paprika	paprik
ražnjići	ražnjilik
kruh	kruh
kruhići	kruhilik
kruščići	kruščilik
slanina	slanini
